ID,Gender,Birth_Year,Seq,3st_LC_Score,3st_RC_Score,3st_Total_Score,학습목표,학습방법,강의 학습 교재 유형,학습빈도,기출문제 공부 횟수,취약분야 인지 여부,토익 모의테스트 횟수,1st_LC_Score,1st_RC_Score,1st_Total_Score,2st_LC_Score,2st_RC_Score,2st_Total_Score,Score_diff_total
1,M,1973,3,345,336,681,승진,온라인강의,영상 교재,주5-6회,7.0,알고 있음,10,181,173,354,227,213,440,241
2,F,1982,3,380,368,748,승진,온라인강의,뉴스/이슈 기반 교재,주5-6회,4.0,알고 있음,14,330,290,620,354,339,693,55
3,F,1995,3,416,382,798,자기계발,참고서,일반적인 영어 텍스트 기반 교재,주1-2회,4.0,알고 있음,4,367,309,676,396,365,761,37
4,M,1987,3,495,397,892,승진,온라인강의,뉴스/이슈 기반 교재,주3-4회,9.0,알고 있음,8,470,285,755,495,341,836,56
5,M,1994,3,398,437,835,자기계발,온라인강의,영상 교재,주3-4회,6.0,알고 있음,4,273,372,645,314,426,740,95
6,F,1997,3,445,352,797,취업,온라인강의,영상 교재,주5-6회,9.0,알고 있음,7,360,256,616,372,269,641,156
7,F,1990,3,495,382,877,자기계발,오프라인강의,비즈니스 시뮬레이션(Role Play),주1-2회,4.0,알고 있음,4,487,337,824,495,341,836,41
8,M,1973,3,145,135,280,자기계발,오프라인강의,비즈니스 시뮬레이션(Role Play),주3-4회,7.0,알고 있지 않음,7,132,129,261,133,130,263,17
9,M,1994,3,354,457,811,승진,온라인강의,뉴스/이슈 기반 교재,주5-6회,8.0,알고 있음,10,256,369,625,322,425,747,64
10,F,1984,3,423,346,769,승진,온라인강의,영상 교재,주5-6회,8.0,알고 있음,8,358,279,637,382,305,687,82
11,F,1991,3,457,309,766,자기계발,참고서,일반적인 영어 텍스트 기반 교재,주1-2회,3.0,알고 있음,6,447,234,681,452,297,749,17
12,M,2007,3,368,476,844,자기계발,온라인강의,뉴스/이슈 기반 교재,주3-4회,5.0,알고 있음,6,300,413,713,332,445,777,67
13,M,1991,3,484,429,913,승진,참고서,일반적인 영어 텍스트 기반 교재,주5-6회,6.0,알고 있음,9,406,321,727,443,388,831,82
14,F,1986,3,470,342,812,승진,참고서,일반적인 영어 텍스트 기반 교재,주5-6회,8.0,알고 있음,7,432,273,705,469,310,779,33
15,F,2005,3,490,329,819,자기계발,온라인강의,뉴스/이슈 기반 교재,주3-4회,4.0,알고 있음,6,487,235,722,489,265,754,65
16,M,1990,3,469,488,957,자기계발,오프라인강의,비즈니스 시뮬레이션(Role Play),주3-4회,6.0,알고 있음,5,465,400,865,466,429,895,62
17,M,1999,3,472,464,936,자기계발,온라인강의,뉴스/이슈 기반 교재,주3-4회,4.0,알고 있음,5,437,403,840,440,432,872,64
18,F,2005,3,435,495,930,자기계발,온라인강의,영상 교재,주5-6회,8.0,알고 있음,9,363,454,817,392,455,847,83
19,F,1992,3,440,439,879,자기계발,오프라인강의,비즈니스 시뮬레이션(Role Play),주5-6회,7.0,알고 있음,8,370,339,709,436,375,811,68
20,M,1995,3,295,295,590,승진,오프라인강의,비즈니스 시뮬레이션(Role Play),매일(주 7회),10.0,알고 있음,6,174,275,449,245,279,524,66
21,F,1997,3,432,428,860,자기계발,온라인강의,영상 교재,주3-4회,5.0,알고 있음,7,359,331,690,415,387,802,58
22,M,1988,3,401,325,726,자기계발,오프라인강의,비즈니스 시뮬레이션(Role Play),주1-2회,2.0,알고 있음,4,336,267,603,359,283,642,84
23,F,1984,3,472,409,881,승진,참고서,일반적인 영어 텍스트 기반 교재,주5-6회,6.0,알고 있음,8,469,289,758,471,380,851,30
24,M,2002,3,391,322,713,취업,온라인강의,영상 교재,주1-2회,3.0,알고 있음,4,306,231,537,308,239,547,166
25,F,1992,3,348,480,828,자기계발,온라인강의,뉴스/이슈 기반 교재,주5-6회,5.0,알고 있지 않음,9,322,478,800,340,479,819,9
26,M,1998,3,433,449,882,자기계발,오프라인강의,비즈니스 시뮬레이션(Role Play),주3-4회,6.0,알고 있음,7,369,385,754,399,415,814,68
27,F,1991,3,327,429,756,자기계발,온라인강의,뉴스/이슈 기반 교재,주3-4회,4.0,알고 있지 않음,8,255,357,612,280,382,662,94
28,M,1985,3,383,415,798,자기계발,오프라인강의,비즈니스 시뮬레이션(Role Play),매일(주 7회),9.0,알고 있음,14,309,341,650,334,366,700,98
29,F,1986,3,371,457,828,자기계발,온라인강의,영상 교재,주3-4회,4.0,알고 있음,8,290,376,666,320,406,726,102
30,M,1986,3,483,416,899,승진,온라인강의,비즈니스 시뮬레이션(Role Play),주1-2회,2.0,알고 있음,4,474,339,813,475,390,865,34
31,F,1985,3,482,412,894,승진,참고서,일반적인 영어 텍스트 기반 교재,주3-4회,5.0,알고 있음,10,476,334,810,479,391,870,24
32,M,1993,3,461,460,921,자기계발,온라인강의,영상 교재,매일(주 7회),9.0,알고 있지 않음,17,355,355,710,404,403,807,114
33,F,2006,3,404,476,880,자기계발,온라인강의,영상 교재,주3-4회,3.0,알고 있음,6,341,413,754,368,440,808,72
34,M,2007,3,436,386,822,자기계발,온라인강의,영상 교재,주3-4회,4.0,알고 있음,8,368,318,686,400,350,750,72
35,F,2000,3,360,426,786,자기계발,온라인강의,영상 교재,주1-2회,2.0,알고 있음,5,291,357,648,328,394,722,64
36,M,1983,3,382,308,690,승진,참고서,일반적인 영어 텍스트 기반 교재,주1-2회,2.0,알고 있지 않음,5,328,248,576,380,300,680,10
37,F,2004,3,426,327,753,자기계발,참고서,일반적인 영어 텍스트 기반 교재,주1-2회,2.0,알고 있음,3,353,251,604,421,319,740,13
38,M,1993,3,493,389,882,자기계발,참고서,일반적인 영어 텍스트 기반 교재,주5-6회,7.0,알고 있음,12,447,314,761,491,358,849,33
39,F,2003,3,392,320,712,자기계발,참고서,일반적인 영어 텍스트 기반 교재,주1-2회,1.0,알고 있음,4,357,282,639,389,314,703,9
40,M,2003,3,343,281,624,자기계발,온라인강의,영상 교재,주3-4회,6.0,알고 있음,12,277,242,519,307,245,552,72
41,F,2000,3,416,339,755,자기계발,참고서,일반적인 영어 텍스트 기반 교재,주1-2회,2.0,알고 있음,5,413,240,653,415,324,739,16
42,M,2002,3,412,485,897,자기계발,참고서,일반적인 영어 텍스트 기반 교재,주1-2회,3.0,알고 있음,7,297,482,779,399,484,883,14
43,F,1995,3,454,381,835,승진,온라인강의,뉴스/이슈 기반 교재,주5-6회,7.0,알고 있음,14,371,298,669,417,344,761,74
44,M,2006,3,331,349,680,자기계발,참고서,일반적인 영어 텍스트 기반 교재,주1-2회,1.0,알고 있음,3,289,307,596,326,344,670,10
45,F,1982,3,495,495,990,자기계발,오프라인강의,비즈니스 시뮬레이션(Role Play),주3-4회,6.0,알고 있음,11,431,484,915,495,488,983,7
46,M,1973,3,319,296,615,승진,오프라인강의,비즈니스 시뮬레이션(Role Play),주1-2회,2.0,알고 있음,4,283,241,524,295,272,567,48
47,F,1988,3,322,354,676,승진,오프라인강의,비즈니스 시뮬레이션(Role Play),주3-4회,4.0,알고 있지 않음,8,262,294,556,283,315,598,78
48,M,1990,3,495,387,882,자기계발,참고서,일반적인 영어 텍스트 기반 교재,매일(주 7회),8.0,알고 있음,18,494,236,730,495,349,844,38
49,F,1995,3,495,375,870,자기계발,참고서,일반적인 영어 텍스트 기반 교재,주1-2회,2.0,알고 있음,5,492,310,802,493,342,835,35
50,M,1994,3,348,339,687,승진,오프라인강의,비즈니스 시뮬레이션(Role Play),주3-4회,3.0,알고 있음,6,279,290,569,309,300,609,78
51,F,1999,3,456,450,906,취업,온라인강의,영상 교재,주5-6회,7.0,알고 있음,15,362,327,689,363,357,720,186
52,M,1998,3,346,378,724,승진,참고서,일반적인 영어 텍스트 기반 교재,주1-2회,2.0,알고 있음,4,283,325,608,335,377,712,12
53,F,2007,3,475,369,844,자기계발,참고서,일반적인 영어 텍스트 기반 교재,주1-2회,1.0,알고 있음,3,440,329,769,472,361,833,11
54,M,2007,3,408,303,711,자기계발,참고서,일반적인 영어 텍스트 기반 교재,주3-4회,4.0,알고 있음,8,371,266,637,398,293,691,20
55,F,1994,3,452,406,858,승진,온라인강의,뉴스/이슈 기반 교재,주5-6회,6.0,알고 있음,12,407,286,693,415,369,784,74
56,M,1994,3,334,344,678,승진,참고서,일반적인 영어 텍스트 기반 교재,주5-6회,8.0,알고 있음,15,289,297,586,319,328,647,31
57,F,1986,3,353,452,805,자기계발,온라인강의,영상 교재,주3-4회,5.0,알고 있지 않음,9,271,399,670,302,400,702,103
58,M,1987,3,358,494,852,승진,오프라인강의,비즈니스 시뮬레이션(Role Play),주3-4회,4.0,알고 있음,7,270,430,700,302,462,764,88
59,F,1986,3,433,491,924,승진,오프라인강의,비즈니스 시뮬레이션(Role Play),주3-4회,5.0,알고 있지 않음,6,266,486,752,375,489,864,60
60,M,1984,3,431,327,758,자기계발,온라인강의,뉴스/이슈 기반 교재,주5-6회,6.0,알고 있음,10,349,245,594,379,275,654,104
61,F,1984,3,392,392,784,승진,오프라인강의,비즈니스 시뮬레이션(Role Play),주5-6회,7.0,알고 있음,8,360,317,677,362,358,720,64
62,M,2006,3,452,392,844,자기계발,온라인강의,뉴스/이슈 기반 교재,주5-6회,7.0,알고 있지 않음,8,448,309,757,449,320,769,75
63,F,1992,3,338,329,667,승진,참고서,일반적인 영어 텍스트 기반 교재,주3-4회,6.0,알고 있음,9,287,307,594,328,322,650,17
64,M,1997,3,479,474,953,취업,참고서,일반적인 영어 텍스트 기반 교재,매일(주 7회),8.0,알고 있음,15,312,435,747,380,440,820,133
65,F,2002,3,468,307,775,자기계발,온라인강의,뉴스/이슈 기반 교재,주1-2회,2.0,알고 있음,4,465,242,707,467,253,720,55
66,M,1991,3,449,481,930,자기계발,온라인강의,뉴스/이슈 기반 교재,주3-4회,5.0,알고 있음,9,295,477,772,355,480,835,95
67,F,1996,3,320,394,714,자기계발,참고서,일반적인 영어 텍스트 기반 교재,주1-2회,3.0,알고 있지 않음,4,324,332,656,300,374,674,40
68,M,1998,3,444,357,801,자기계발,참고서,일반적인 영어 텍스트 기반 교재,주5-6회,6.0,알고 있음,7,381,291,672,413,326,739,62
69,F,1988,3,376,351,727,자기계발,오프라인강의,비즈니스 시뮬레이션(Role Play),주5-6회,7.0,알고 있음,13,313,321,634,324,325,649,78
70,M,1990,3,232,225,457,자기계발,참고서,일반적인 영어 텍스트 기반 교재,주5-6회,7.0,알고 있음,12,181,174,355,201,194,395,62
71,F,2006,3,321,438,759,자기계발,참고서,일반적인 영어 텍스트 기반 교재,주3-4회,4.0,알고 있음,6,279,396,675,310,427,737,22
72,M,1993,3,382,378,760,자기계발,온라인강의,뉴스/이슈 기반 교재,주5-6회,7.0,알고 있음,10,319,319,638,325,321,646,114
73,F,1981,3,382,409,791,승진,온라인강의,뉴스/이슈 기반 교재,주5-6회,8.0,알고 있음,12,316,327,643,321,328,649,142
74,M,1997,3,338,470,808,승진,참고서,일반적인 영어 텍스트 기반 교재,주5-6회,5.0,알고 있지 않음,10,259,467,726,309,468,777,31
75,F,1996,3,465,485,950,취업,온라인강의,영상 교재,주1-2회,2.0,알고 있음,3,371,328,699,419,365,784,166
76,M,1985,3,291,209,500,자기계발,참고서,일반적인 영어 텍스트 기반 교재,매일(주 7회),10.0,알고 있음,17,254,124,378,286,194,480,20
77,F,2006,3,387,412,799,자기계발,온라인강의,뉴스/이슈 기반 교재,주1-2회,3.0,알고 있음,2,365,312,677,378,358,736,63
78,M,1994,3,321,328,649,자기계발,오프라인강의,비즈니스 시뮬레이션(Role Play),주1-2회,1.0,알고 있음,4,297,287,584,317,321,638,11
79,F,1984,3,337,283,620,승진,오프라인강의,비즈니스 시뮬레이션(Role Play),주3-4회,5.0,알고 있음,9,307,253,560,327,278,605,15
80,M,1989,3,337,360,697,자기계발,참고서,일반적인 영어 텍스트 기반 교재,매일(주 7회),9.0,알고 있음,20,273,296,569,307,330,637,60
81,F,1991,3,337,424,761,승진,오프라인강의,비즈니스 시뮬레이션(Role Play),주3-4회,5.0,알고 있음,11,261,348,609,308,395,703,58
82,M,1993,3,431,356,787,자기계발,온라인강의,뉴스/이슈 기반 교재,주1-2회,2.0,알고 있음,4,362,287,649,412,314,726,61
83,F,2000,3,291,152,443,자기계발,참고서,일반적인 영어 텍스트 기반 교재,주1-2회,1.0,알고 있음,5,285,84,369,286,147,433,10
84,M,1999,3,495,445,940,자기계발,온라인강의,뉴스/이슈 기반 교재,주3-4회,6.0,알고 있지 않음,13,488,378,866,493,383,876,64
85,F,1988,3,337,312,649,자기계발,참고서,일반적인 영어 텍스트 기반 교재,주5-6회,7.0,알고 있음,15,269,267,536,331,301,632,17
86,M,1990,3,315,334,649,승진,오프라인강의,비즈니스 시뮬레이션(Role Play),주5-6회,7.0,알고 있음,16,309,321,630,312,332,644,5
87,F,1992,3,278,331,609,자기계발,오프라인강의,비즈니스 시뮬레이션(Role Play),주5-6회,7.0,알고 있음,13,153,228,381,200,275,475,134
88,M,1986,3,495,495,990,자기계발,오프라인강의,비즈니스 시뮬레이션(Role Play),주3-4회,3.0,알고 있음,13,424,456,880,487,495,982,8
89,F,1992,3,355,494,849,승진,오프라인강의,비즈니스 시뮬레이션(Role Play),주3-4회,4.0,알고 있음,8,255,451,706,297,493,790,59
90,M,1989,3,220,213,433,승진,참고서,일반적인 영어 텍스트 기반 교재,주3-4회,4.0,알고 있음,7,190,186,376,201,198,399,34
91,F,1993,3,322,327,649,자기계발,온라인강의,영상 교재,주1-2회,2.0,알고 있음,2,301,328,629,321,321,642,7
92,M,2007,3,495,495,990,자기계발,온라인강의,영상 교재,주3-4회,5.0,알고 있음,10,491,479,970,495,495,990,0
93,F,1987,3,327,322,649,승진,온라인강의,뉴스/이슈 기반 교재,주5-6회,6.0,알고 있음,8,274,264,538,312,289,601,48
94,M,1992,3,468,438,906,취업,온라인강의,영상 교재,주5-6회,4.0,알고 있지 않음,15,370,330,700,375,345,720,186
95,F,2005,3,339,433,772,자기계발,참고서,일반적인 영어 텍스트 기반 교재,주1-2회,1.0,알고 있음,2,293,395,688,330,432,762,10
96,M,1994,3,495,495,990,취업,온라인강의,영상 교재,주1-2회,2.0,알고 있음,3,433,442,875,443,453,896,94
97,F,1975,3,454,396,850,자기계발,온라인강의,영상 교재,주3-4회,4.0,알고 있음,8,451,235,686,452,294,746,104
98,M,2006,3,319,331,650,자기계발,온라인강의,뉴스/이슈 기반 교재,매일(주 7회),10.0,알고 있음,18,298,291,589,301,325,626,24
99,F,2006,3,420,387,807,자기계발,온라인강의,뉴스/이슈 기반 교재,주1-2회,2.0,알고 있음,4,392,351,743,393,360,753,54
100,M,1994,3,395,395,790,자기계발,참고서,일반적인 영어 텍스트 기반 교재,주1-2회,2.0,알고 있음,1,355,365,720,380,390,770,20
101,F,2002,3,351,318,669,자기계발,오프라인강의,뉴스/이슈 기반 교재,주3-4회,5.0,알고 있음,9,303,268,571,322,278,600,69
102,M,1984,3,316,327,643,승진,오프라인강의,비즈니스 시뮬레이션(Role Play),주3-4회,3.0,알고 있음,7,198,312,510,309,331,640,3
103,F,2005,3,382,431,813,자기계발,참고서,일반적인 영어 텍스트 기반 교재,주1-2회,1.0,알고 있음,4,290,429,719,373,430,803,10
104,M,1990,3,410,354,764,자기계발,참고서,일반적인 영어 텍스트 기반 교재,주5-6회,5.0,알고 있음,12,293,281,574,351,301,652,112
105,F,2005,3,295,295,590,자기계발,온라인강의,뉴스/이슈 기반 교재,주5-6회,4.0,알고 있음,15,253,285,538,262,286,548,42
106,M,1986,3,468,473,941,승진,오프라인강의,비즈니스 시뮬레이션(Role Play),주3-4회,5.0,알고 있음,6,373,470,843,412,471,883,58
107,F,1990,3,365,394,759,자기계발,온라인강의,영상 교재,주3-4회,5.0,알고 있음,9,311,341,652,314,342,656,103
108,M,1995,3,495,495,990,자기계발,참고서,일반적인 영어 텍스트 기반 교재,주1-2회,2.0,알고 있음,2,348,448,796,495,467,962,28
109,F,1989,3,495,495,990,자기계발,참고서,일반적인 영어 텍스트 기반 교재,주3-4회,4.0,알고 있음,8,491,475,966,495,495,990,0
110,M,1994,3,495,495,990,자기계발,온라인강의,영상 교재,매일(주 7회),9.0,알고 있음,19,475,470,945,495,495,990,0
111,F,1987,3,411,458,869,자기계발,온라인강의,영상 교재,주3-4회,6.0,알고 있음,17,344,391,735,359,406,765,104
112,M,1976,3,354,378,732,자기계발,오프라인강의,비즈니스 시뮬레이션(Role Play),주3-4회,6.0,알고 있음,7,264,287,551,310,334,644,88
113,F,1995,3,488,433,921,자기계발,오프라인강의,비즈니스 시뮬레이션(Role Play),매일(주 7회),9.0,알고 있음,18,485,235,720,486,337,823,98
114,M,1988,3,434,373,807,자기계발,온라인강의,영상 교재,주3-4회,6.0,알고 있음,5,377,317,694,382,322,704,103
115,F,1992,3,340,309,649,승진,온라인강의,뉴스/이슈 기반 교재,주5-6회,7.0,알고 있음,14,318,303,621,325,305,630,19
116,M,1981,3,357,465,822,승진,오프라인강의,비즈니스 시뮬레이션(Role Play),주5-6회,6.0,알고 있음,11,281,389,670,323,431,754,68
117,F,1994,3,450,475,925,자기계발,온라인강의,영상 교재,매일(주 7회),8.0,알고 있음,20,437,307,744,438,374,812,113
118,M,1986,3,280,294,574,자기계발,오프라인강의,비즈니스 시뮬레이션(Role Play),주1-2회,2.0,알고 있음,2,255,193,448,279,217,496,78
119,F,1997,3,388,397,785,자기계발,참고서,일반적인 영어 텍스트 기반 교재,매일(주 7회),9.0,알고 있음,17,329,338,667,358,367,725,60
120,M,1996,3,424,341,765,자기계발,참고서,일반적인 영어 텍스트 기반 교재,주3-4회,4.0,알고 있음,6,347,310,657,399,316,715,50
121,F,1996,3,454,437,891,자기계발,오프라인강의,비즈니스 시뮬레이션(Role Play),주3-4회,5.0,알고 있음,7,409,281,690,410,393,803,88
122,M,1986,3,295,237,532,자기계발,참고서,일반적인 영어 텍스트 기반 교재,주3-4회,6.0,알고 있음,11,278,156,434,295,187,482,50
123,F,1992,3,432,467,899,자기계발,온라인강의,영상 교재,주3-4회,3.0,알고 있음,7,293,429,722,330,466,796,103
124,M,1983,3,253,293,546,승진,온라인강의,뉴스/이슈 기반 교재,주3-4회,5.0,알고 있음,10,159,262,421,189,292,481,65
125,F,1998,3,490,429,919,자기계발,오프라인강의,영상 교재,주1-2회,1.0,알고 있음,4,486,271,757,487,339,826,93
126,M,1992,3,463,391,854,승진,오프라인강의,비즈니스 시뮬레이션(Role Play),매일(주 7회),9.0,알고 있음,16,458,233,691,459,327,786,68
127,F,1993,3,315,321,636,자기계발,온라인강의,영상 교재,주3-4회,2.0,알고 있음,7,293,276,569,315,315,630,6
128,M,1993,3,466,364,830,취업,온라인강의,영상 교재,주5-6회,6.0,알고 있음,14,341,239,580,373,271,644,186
129,F,1990,3,456,457,913,자기계발,오프라인강의,영상 교재,주1-2회,1.0,알고 있음,3,452,310,762,453,367,820,93
130,M,1985,3,394,398,792,승진,온라인강의,영상 교재,매일(주 7회),10.0,알고 있음,16,305,310,615,352,331,683,109
131,F,2004,3,310,335,645,자기계발,온라인강의,뉴스/이슈 기반 교재,주1-2회,1.0,알고 있음,3,257,265,522,272,280,552,93
132,M,1983,3,398,470,868,승진,온라인강의,뉴스/이슈 기반 교재,주5-6회,7.0,알고 있음,15,329,407,736,361,447,808,60
133,F,1992,3,398,325,723,승진,오프라인강의,영상 교재,주3-4회,4.0,알고 있음,12,331,258,589,361,288,649,74
134,M,1995,3,379,319,698,자기계발,온라인강의,일반적인 영어 텍스트 기반 교재,주5-6회,6.0,알고 있음,14,317,252,569,356,291,647,51
135,F,1988,3,402,381,783,자기계발,오프라인강의,영상 교재,주1-2회,1.0,알고 있음,3,319,298,617,356,335,691,92
136,M,1996,3,411,472,883,자기계발,온라인강의,뉴스/이슈 기반 교재,주3-4회,5.0,알고 있음,6,305,451,756,344,452,796,87
137,F,1982,3,326,316,642,자기계발,온라인강의,영상 교재,주3-4회,3.0,알고 있음,6,269,251,520,295,278,573,69
138,M,2004,3,396,317,713,자기계발,온라인강의,뉴스/이슈 기반 교재,주3-4회,3.0,알고 있음,7,332,254,586,364,285,649,64
139,F,1997,3,295,297,592,취업,오프라인강의,영상 교재,주5-6회,6.0,알고 있음,16,272,239,511,273,268,541,51
140,M,2001,3,331,368,699,자기계발,온라인강의,뉴스/이슈 기반 교재,주5-6회,9.0,알고 있지 않음,15,278,295,573,321,331,652,47
141,F,1992,3,395,395,790,자기계발,참고서,일반적인 영어 텍스트 기반 교재,주1-2회,1.0,알고 있음,4,344,393,737,395,395,790,0
142,M,1993,3,295,295,590,승진,오프라인강의,비즈니스 시뮬레이션(Role Play),매일(주 7회),8.0,알고 있음,20,262,273,535,295,295,590,0
143,F,1984,3,447,372,819,자기계발,온라인강의,뉴스/이슈 기반 교재,주3-4회,4.0,알고 있음,8,381,306,687,408,333,741,78
144,M,1993,3,494,493,987,승진,오프라인강의,비즈니스 시뮬레이션(Role Play),주3-4회,4.0,알고 있음,14,386,439,825,438,491,929,58
145,F,1992,3,376,489,865,자기계발,참고서,일반적인 영어 텍스트 기반 교재,매일(주 7회),8.0,알고 있음,17,260,486,746,317,487,804,61
146,M,1980,3,493,464,957,자기계발,오프라인강의,비즈니스 시뮬레이션(Role Play),주1-2회,1.0,알고 있음,4,457,364,821,465,414,879,78
147,F,2004,3,352,446,798,자기계발,참고서,뉴스/이슈 기반 교재,주3-4회,7.0,알고 있음,15,273,441,714,292,442,734,64
148,M,1993,3,295,295,590,자기계발,온라인강의,뉴스/이슈 기반 교재,주3-4회,5.0,알고 있음,11,262,273,535,295,295,590,0
149,F,1991,3,377,474,851,자기계발,참고서,일반적인 영어 텍스트 기반 교재,주1-2회,1.0,알고 있음,4,320,417,737,357,454,811,40
150,M,2004,3,476,374,850,자기계발,오프라인강의,뉴스/이슈 기반 교재,주3-4회,2.0,알고 있음,5,403,300,703,444,342,786,64
151,F,2004,3,348,461,809,자기계발,온라인강의,뉴스/이슈 기반 교재,주5-6회,6.0,알고 있지 않음,15,275,388,663,311,424,735,74
152,M,1982,3,395,395,790,승진,오프라인강의,영상 교재,주3-4회,4.0,알고 있음,8,367,328,695,368,387,755,35
153,F,1983,3,471,492,963,승진,오프라인강의,영상 교재,주5-6회,7.0,알고 있음,13,361,442,803,400,481,881,82
154,M,2000,3,292,263,555,자기계발,참고서,일반적인 영어 텍스트 기반 교재,매일(주 7회),9.0,알고 있음,18,289,163,452,290,235,525,30
155,F,1990,3,338,447,785,자기계발,오프라인강의,비즈니스 시뮬레이션(Role Play),주1-2회,2.0,알고 있음,3,284,393,677,299,408,707,78
156,M,1999,3,411,381,792,승진,온라인강의,영상 교재,매일(주 7회),10.0,알고 있음,20,339,310,649,357,337,694,98
157,F,2005,3,357,353,710,자기계발,온라인강의,영상 교재,주3-4회,3.0,알고 있음,6,289,285,574,321,317,638,72
158,M,1999,3,475,395,870,승진,오프라인강의,비즈니스 시뮬레이션(Role Play),매일(주 7회),8.0,알고 있지 않음,19,464,234,698,467,334,801,69
159,F,1981,3,401,326,727,승진,참고서,일반적인 영어 텍스트 기반 교재,주5-6회,6.0,알고 있음,10,335,260,595,386,311,697,30
160,M,1986,3,280,284,564,승진,온라인강의,영상 교재,주3-4회,2.0,알고 있음,4,210,241,451,230,261,491,73
161,F,2002,3,384,329,713,승진,온라인강의,비즈니스 시뮬레이션(Role Play),주3-4회,6.0,알고 있음,11,308,253,561,355,300,655,58
162,M,1994,3,361,468,829,취업,온라인강의,뉴스/이슈 기반 교재,주3-4회,4.0,알고 있음,6,272,380,652,277,385,662,167
163,F,1989,3,381,390,771,자기계발,오프라인강의,뉴스/이슈 기반 교재,주3-4회,3.0,알고 있음,6,314,323,637,334,343,677,94
164,M,1988,3,348,350,698,자기계발,오프라인강의,비즈니스 시뮬레이션(Role Play),주1-2회,1.0,알고 있음,2,268,270,538,309,311,620,78
165,F,1996,3,316,402,718,자기계발,온라인강의,뉴스/이슈 기반 교재,주3-4회,5.0,알고 있지 않음,14,254,340,594,269,355,624,94
166,M,2007,3,357,456,813,자기계발,참고서,일반적인 영어 텍스트 기반 교재,매일(주 7회),9.0,알고 있음,11,310,409,719,342,441,783,30
167,F,1998,3,393,394,787,승진,오프라인강의,비즈니스 시뮬레이션(Role Play),주1-2회,2.0,알고 있음,4,278,367,645,348,391,739,48
168,M,1985,3,338,333,671,자기계발,온라인강의,뉴스/이슈 기반 교재,주3-4회,4.0,알고 있음,6,276,271,547,291,286,577,94
169,F,1989,3,391,444,835,승진,온라인강의,영상 교재,주3-4회,3.0,알고 있지 않음,8,280,441,721,319,442,761,74
170,M,1997,3,295,295,590,승진,오프라인강의,비즈니스 시뮬레이션(Role Play),주3-4회,4.0,알고 있음,8,222,240,462,295,295,590,0
171,F,1991,3,423,485,908,승진,오프라인강의,비즈니스 시뮬레이션(Role Play),주3-4회,4.0,알고 있음,8,342,404,746,394,456,850,58
172,M,1991,3,419,390,809,승진,참고서,뉴스/이슈 기반 교재,주5-6회,7.0,알고 있음,13,352,323,675,382,353,735,74
173,F,2005,3,363,386,749,자기계발,참고서,뉴스/이슈 기반 교재,주3-4회,5.0,알고 있음,10,291,374,665,301,384,685,64
174,M,1990,3,343,478,821,승진,온라인강의,영상 교재,주3-4회,2.0,알고 있음,3,286,398,684,306,442,748,73
175,F,1983,3,351,419,770,승진,오프라인강의,일반적인 영어 텍스트 기반 교재,주1-2회,2.0,알고 있음,3,314,382,696,346,414,760,10
176,M,1977,3,463,320,783,승진,참고서,일반적인 영어 텍스트 기반 교재,주5-6회,6.0,알고 있음,16,410,239,649,462,291,753,30
177,F,1980,3,383,371,754,자기계발,오프라인강의,뉴스/이슈 기반 교재,주3-4회,4.0,알고 있음,12,321,309,630,336,324,660,94
178,M,1995,3,470,469,939,취업,참고서,일반적인 영어 텍스트 기반 교재,주5-6회,7.0,알고 있음,11,300,431,731,337,468,805,134
179,F,1993,3,408,453,861,자기계발,온라인강의,영상 교재,주5-6회,6.0,알고 있음,12,299,346,645,351,397,748,113
180,M,1983,3,403,438,841,자기계발,온라인강의,비즈니스 시뮬레이션(Role Play),주3-4회,3.0,알고 있음,7,344,379,723,359,394,753,88
181,F,1985,3,380,398,778,자기계발,오프라인강의,일반적인 영어 텍스트 기반 교재,주3-4회,3.0,알고 있음,10,326,344,670,355,373,728,50
182,M,1994,3,411,382,793,자기계발,온라인강의,영상 교재,주3-4회,6.0,알고 있지 않음,11,311,281,592,360,330,690,103
183,F,2004,3,332,290,622,자기계발,오프라인강의,일반적인 영어 텍스트 기반 교재,주1-2회,1.0,알고 있음,5,286,243,529,327,285,612,10
184,M,1987,3,280,220,500,승진,참고서,일반적인 영어 텍스트 기반 교재,주5-6회,6.0,알고 있음,9,216,156,372,265,205,470,30
185,F,1986,3,494,388,882,자기계발,오프라인강의,비즈니스 시뮬레이션(Role Play),주3-4회,4.0,알고 있음,5,449,297,746,450,344,794,88
186,M,2007,3,476,343,819,자기계발,온라인강의,뉴스/이슈 기반 교재,주3-4회,3.0,알고 있음,7,439,306,745,444,311,755,64
187,F,1986,3,486,415,901,자기계발,온라인강의,비즈니스 시뮬레이션(Role Play),주5-6회,9.0,알고 있음,14,483,246,729,484,319,803,98
188,M,1993,3,310,372,682,자기계발,오프라인강의,일반적인 영어 텍스트 기반 교재,주3-4회,3.0,알고 있지 않음,7,302,368,670,306,370,676,6
189,F,1993,3,295,295,590,승진,오프라인강의,비즈니스 시뮬레이션(Role Play),주3-4회,6.0,알고 있음,6,113,279,392,269,280,549,41
190,M,1998,3,342,319,661,승진,참고서,일반적인 영어 텍스트 기반 교재,매일(주 7회),9.0,알고 있음,18,252,300,552,327,304,631,30
191,F,2004,3,438,456,894,승진,온라인강의,뉴스/이슈 기반 교재,매일(주 7회),10.0,알고 있음,15,264,453,717,366,454,820,74
192,M,1982,3,476,431,907,승진,오프라인강의,비즈니스 시뮬레이션(Role Play),주1-2회,2.0,알고 있음,3,473,377,850,475,384,859,48
193,F,2005,3,476,470,946,취업,오프라인강의,일반적인 영어 텍스트 기반 교재,주5-6회,6.0,알고 있음,16,398,301,699,446,367,813,133
194,M,1980,3,388,447,835,승진,온라인강의,비즈니스 시뮬레이션(Role Play),주3-4회,3.0,알고 있음,6,302,362,664,359,418,777,58
195,F,2002,3,412,417,829,자기계발,참고서,일반적인 영어 텍스트 기반 교재,주1-2회,1.0,알고 있지 않음,4,405,408,813,409,411,820,9
196,M,1999,3,473,483,956,취업,오프라인강의,영상 교재,주1-2회,2.0,알고 있음,4,466,229,695,467,323,790,166
197,F,2007,3,308,362,670,자기계발,오프라인강의,뉴스/이슈 기반 교재,주5-6회,7.0,알고 있음,13,269,322,591,271,325,596,74
198,M,1986,3,388,494,882,자기계발,온라인강의,뉴스/이슈 기반 교재,주5-6회,6.0,알고 있음,12,310,420,730,334,444,778,104
199,F,1999,3,334,313,647,자기계발,참고서,일반적인 영어 텍스트 기반 교재,주1-2회,2.0,알고 있음,3,327,289,616,330,293,623,24
200,M,1981,3,295,295,590,자기계발,오프라인강의,뉴스/이슈 기반 교재,주5-6회,7.0,알고 있음,13,262,219,481,277,234,511,79
201,F,1990,3,409,445,854,승진,오프라인강의,영상 교재,매일(주 7회),9.0,알고 있음,16,308,424,732,328,443,771,83
202,M,2007,3,440,471,911,자기계발,참고서,일반적인 영어 텍스트 기반 교재,주3-4회,4.0,알고 있음,9,426,454,880,431,459,890,21
203,F,1992,3,492,489,981,자기계발,참고서,일반적인 영어 텍스트 기반 교재,주1-2회,1.0,알고 있음,2,490,445,935,491,450,941,40
204,M,2000,3,162,253,415,승진,참고서,일반적인 영어 텍스트 기반 교재,주1-2회,2.0,알고 있음,3,150,245,395,157,248,405,10
205,F,1997,3,466,430,896,자기계발,온라인강의,뉴스/이슈 기반 교재,주3-4회,3.0,알고 있음,5,419,383,802,434,398,832,64
206,M,2003,3,418,437,855,자기계발,참고서,일반적인 영어 텍스트 기반 교재,주3-4회,4.0,알고 있음,7,401,423,824,407,428,835,20
207,F,1982,3,306,360,666,승진,오프라인강의,비즈니스 시뮬레이션(Role Play),매일(주 7회),10.0,알고 있음,16,265,323,588,272,326,598,68
208,M,1990,3,295,295,590,자기계발,오프라인강의,비즈니스 시뮬레이션(Role Play),주1-2회,2.0,알고 있음,3,231,264,495,282,294,576,14
209,F,1989,3,371,482,853,승진,오프라인강의,비즈니스 시뮬레이션(Role Play),매일(주 7회),8.0,알고 있음,17,312,423,735,337,448,785,68
210,M,1998,3,277,294,571,자기계발,온라인강의,영상 교재,주5-6회,9.0,알고 있음,10,169,196,365,216,243,459,112
211,F,1983,3,455,413,868,자기계발,온라인강의,비즈니스 시뮬레이션(Role Play),주1-2회,1.0,알고 있음,4,375,332,707,431,389,820,48
212,M,2003,3,294,294,588,자기계발,오프라인강의,뉴스/이슈 기반 교재,주5-6회,7.0,알고 있음,14,292,141,433,293,223,516,72
213,F,1980,3,426,468,894,자기계발,온라인강의,일반적인 영어 텍스트 기반 교재,주1-2회,2.0,알고 있음,2,332,454,786,396,458,854,40
214,M,2002,3,295,295,590,자기계발,오프라인강의,영상 교재,주3-4회,4.0,알고 있음,8,242,256,498,279,293,572,18
215,F,1981,3,271,284,555,승진,오프라인강의,뉴스/이슈 기반 교재,주5-6회,5.0,알고 있음,10,229,242,471,234,247,481,74
216,M,2006,3,345,421,766,자기계발,오프라인강의,일반적인 영어 텍스트 기반 교재,주3-4회,4.0,알고 있음,7,309,383,692,336,410,746,20
217,F,1987,3,411,423,834,자기계발,온라인강의,뉴스/이슈 기반 교재,주5-6회,8.0,알고 있음,5,334,315,649,339,360,699,135
218,M,2003,3,370,445,815,자기계발,오프라인강의,뉴스/이슈 기반 교재,주3-4회,5.0,알고 있음,6,333,408,741,338,413,751,64
219,F,1999,3,453,371,824,자기계발,오프라인강의,뉴스/이슈 기반 교재,주1-2회,2.0,알고 있음,3,423,338,761,426,344,770,54
220,M,1986,3,276,281,557,승진,온라인강의,영상 교재,주5-6회,6.0,알고 있음,8,272,190,462,275,198,473,84
221,F,1987,3,460,468,928,자기계발,참고서,일반적인 영어 텍스트 기반 교재,주5-6회,7.0,알고 있음,12,398,406,804,430,438,868,60
222,M,1983,3,250,203,453,승진,오프라인강의,비즈니스 시뮬레이션(Role Play),매일(주 7회),10.0,알고 있음,15,247,127,374,248,135,383,70
223,F,1992,3,495,449,964,자기계발,참고서,일반적인 영어 텍스트 기반 교재,주5-6회,8.0,알고 있음,9,490,425,915,495,434,934,30
224,M,2005,3,473,476,949,자기계발,온라인강의,영상 교재,매일(주 7회),9.0,알고 있음,18,348,444,792,420,446,866,83
225,F,1989,3,350,316,666,자기계발,참고서,일반적인 영어 텍스트 기반 교재,주3-4회,3.0,알고 있음,6,321,287,608,325,291,616,50
226,M,2003,3,226,227,453,자기계발,참고서,일반적인 영어 텍스트 기반 교재,주1-2회,2.0,알고 있음,3,138,221,359,221,222,443,10
227,M,1983,3,431,473,904,승진,오프라인강의,비즈니스 시뮬레이션(Role Play),매일(주 7회),10.0,알고 있음,16,304,438,742,397,439,836,68
228,F,2001,3,269,282,551,자기계발,온라인강의,뉴스/이슈 기반 교재,매일(주 7회),9.0,알고 있음,12,228,239,467,232,245,477,74
229,M,2001,3,469,451,920,자기계발,오프라인강의,비즈니스 시뮬레이션(Role Play),매일(주 7회),7.0,알고 있음,18,348,424,772,373,449,822,98
230,F,2007,3,385,320,705,자기계발,온라인강의,뉴스/이슈 기반 교재,주3-4회,3.0,알고 있음,6,348,283,631,353,288,641,64
231,F,1997,3,344,335,679,승진,오프라인강의,비즈니스 시뮬레이션(Role Play),주1-2회,2.0,알고 있지 않음,3,335,325,660,339,331,670,9
232,M,2006,3,279,239,518,자기계발,오프라인강의,뉴스/이슈 기반 교재,매일(주 7회),10.0,알고 있음,17,241,173,414,242,202,444,74
233,F,1988,3,484,486,970,승진,오프라인강의,뉴스/이슈 기반 교재,주5-6회,6.0,알고 있음,9,347,471,818,424,472,896,74
234,M,1987,3,495,495,990,자기계발,온라인강의,일반적인 영어 텍스트 기반 교재,주1-2회,1.0,알고 있음,5,449,445,894,483,479,962,28
235,F,1981,3,225,274,499,승진,온라인강의,뉴스/이슈 기반 교재,주3-4회,3.0,알고 있음,6,160,271,431,162,273,435,64
236,M,2002,3,487,493,980,자기계발,오프라인강의,영상 교재,주5-6회,8.0,알고 있음,8,432,458,890,437,460,897,83
237,F,1985,3,386,382,768,승진,오프라인강의,영상 교재,주1-2회,1.0,알고 있음,3,275,332,607,324,381,705,63
238,M,1983,3,285,332,617,자기계발,오프라인강의,영상 교재,주1-2회,2.0,알고 있지 않음,2,277,323,600,279,327,606,11
239,F,2003,3,248,246,494,자기계발,온라인강의,뉴스/이슈 기반 교재,주3-4회,3.0,알고 있음,8,215,141,356,216,214,430,64
240,M,1996,3,244,198,442,승진,온라인강의,뉴스/이슈 기반 교재,주3-4회,5.0,알고 있음,4,207,160,367,212,166,378,64
241,F,1986,3,298,281,579,자기계발,참고서,일반적인 영어 텍스트 기반 교재,주1-2회,1.0,알고 있음,4,189,190,379,251,249,500,79
242,M,1990,3,289,216,505,승진,온라인강의,뉴스/이슈 기반 교재,주3-4회,3.0,알고 있음,6,286,145,431,287,153,440,65
243,F,1984,3,295,295,590,승진,온라인강의,영상 교재,매일(주 7회),7.0,알고 있음,18,293,220,513,294,226,520,70
244,M,1999,3,330,342,672,승진,온라인강의,일반적인 영어 텍스트 기반 교재,매일(주 7회),9.0,알고 있음,16,283,236,519,295,295,590,82
245,F,2001,3,267,252,519,자기계발,온라인강의,뉴스/이슈 기반 교재,주3-4회,3.0,알고 있음,8,199,246,445,207,248,455,64
246,M,1997,3,231,299,530,자기계발,참고서,일반적인 영어 텍스트 기반 교재,주1-2회,1.0,알고 있음,3,221,290,511,226,294,520,10
247,F,2005,3,417,437,854,자기계발,온라인강의,영상 교재,주3-4회,3.0,알고 있음,5,327,433,760,347,434,781,73
248,M,1980,3,394,376,770,자기계발,온라인강의,비즈니스 시뮬레이션(Role Play),주5-6회,8.0,알고 있음,12,341,322,663,345,327,672,98
249,F,1982,3,495,495,990,자기계발,참고서,뉴스/이슈 기반 교재,주5-6회,5.0,알고 있음,12,451,490,941,495,495,990,0
250,M,2006,3,370,471,841,자기계발,참고서,일반적인 영어 텍스트 기반 교재,주1-2회,1.0,알고 있음,4,302,463,765,365,464,829,12
251,F,1981,3,379,410,789,자기계발,온라인강의,영상 교재,주3-4회,4.0,알고 있음,17,319,356,675,327,359,686,103
252,M,1986,3,208,264,472,승진,오프라인강의,비즈니스 시뮬레이션(Role Play),주1-2회,1.0,알고 있음,4,157,259,416,161,263,424,48
253,F,1990,3,295,295,590,승진,오프라인강의,비즈니스 시뮬레이션(Role Play),주1-2회,2.0,알고 있음,3,276,224,500,295,295,590,0
254,M,1996,3,313,325,638,자기계발,온라인강의,비즈니스 시뮬레이션(Role Play),주5-6회,5.0,알고 있지 않음,15,301,313,614,308,317,625,13
255,F,2001,3,424,407,831,자기계발,참고서,일반적인 영어 텍스트 기반 교재,매일(주 7회),10.0,알고 있음,14,378,360,738,409,392,801,30
256,M,2004,3,285,286,571,자기계발,오프라인강의,뉴스/이슈 기반 교재,주1-2회,4.0,알고 있음,1,257,186,443,258,259,517,54
257,F,1995,3,295,295,590,자기계발,온라인강의,뉴스/이슈 기반 교재,주3-4회,3.0,알고 있음,7,268,199,467,269,259,528,62
258,M,1991,3,261,248,509,승진,오프라인강의,영상 교재,주3-4회,4.0,알고 있음,7,200,187,387,225,212,437,72
259,F,1989,3,438,480,918,자기계발,참고서,뉴스/이슈 기반 교재,주5-6회,8.0,알고 있음,12,319,427,746,386,428,814,104
260,M,1994,3,218,293,511,승진,오프라인강의,비즈니스 시뮬레이션(Role Play),주5-6회,5.0,알고 있음,10,143,291,434,151,292,443,68
261,F,1982,3,415,413,828,승진,온라인강의,영상 교재,매일(주 7회),8.0,알고 있음,20,346,353,699,373,372,745,83
262,M,1998,3,175,262,437,자기계발,온라인강의,뉴스/이슈 기반 교재,주1-2회,2.0,알고 있음,3,116,257,373,125,258,383,54
263,F,1988,3,293,293,586,승진,오프라인강의,비즈니스 시뮬레이션(Role Play),주3-4회,3.0,알고 있음,9,198,226,424,250,278,528,58
264,M,1995,3,295,295,590,자기계발,온라인강의,뉴스/이슈 기반 교재,주1-2회,1.0,알고 있음,2,246,252,498,276,282,558,32
265,F,2003,3,292,262,554,자기계발,참고서,일반적인 영어 텍스트 기반 교재,매일(주 7회),9.0,알고 있음,18,290,168,458,291,232,523,31
266,M,1989,3,385,372,757,자기계발,참고서,일반적인 영어 텍스트 기반 교재,주3-4회,4.0,알고 있음,9,335,323,658,374,362,736,21
267,F,2001,3,486,493,979,자기계발,온라인강의,비즈니스 시뮬레이션(Role Play),주5-6회,6.0,알고 있음,13,321,475,796,405,476,881,98
268,M,1988,3,489,464,953,자기계발,온라인강의,영상 교재,매일(주 7회),7.0,알고 있음,17,432,350,782,433,407,840,113
269,F,1991,3,495,495,990,자기계발,오프라인강의,영상 교재,주5-6회,6.0,알고 있음,12,487,433,920,489,438,927,63
270,M,1992,3,275,246,521,승진,오프라인강의,비즈니스 시뮬레이션(Role Play),주1-2회,2.0,알고 있음,3,250,216,466,251,222,473,48
271,F,2006,3,294,382,676,자기계발,온라인강의,영상 교재,주1-2회,1.0,알고 있음,4,222,379,601,231,380,611,65
271,F,2001,3,294,382,676,자기계발,온라인강의,영상 교재,주1-2회,1.0,알고 있음,4,222,379,601,231,380,611,65
272,M,1998,3,387,407,794,승진,오프라인강의,영상 교재,주5-6회,5.0,알고 있음,8,303,324,627,345,351,696,98
273,F,2003,3,301,346,647,자기계발,온라인강의,영상 교재,매일(주 7회),10.0,알고 있음,13,210,343,553,218,345,563,84
274,M,2001,3,334,257,591,자기계발,참고서,일반적인 영어 텍스트 기반 교재,주5-6회,7.0,알고 있음,11,315,235,550,319,242,561,30
274,M,2006,3,334,257,591,자기계발,참고서,일반적인 영어 텍스트 기반 교재,주5-6회,7.0,알고 있음,11,315,235,550,319,242,561,30
275,F,1982,3,487,488,975,자기계발,온라인강의,영상 교재,주3-4회,5.0,알고 있음,6,433,432,865,435,437,872,103
276,M,2003,3,292,294,586,자기계발,오프라인강의,영상 교재,주3-4회,3.0,알고 있음,8,254,184,438,255,258,513,73
277,F,1987,3,409,379,788,승진,오프라인강의,비즈니스 시뮬레이션(Role Play),주1-2회,2.0,알고 있음,3,355,325,680,385,355,740,48
278,M,1990,3,414,405,819,승진,오프라인강의,비즈니스 시뮬레이션(Role Play),매일(주 7회),10.0,알고 있음,14,405,337,742,408,345,753,66
279,F,2001,3,385,418,803,자기계발,참고서,일반적인 영어 텍스트 기반 교재,주3-4회,4.0,알고 있음,6,311,352,663,374,416,790,13
280,M,1997,3,295,295,590,취업,온라인강의,영상 교재,매일(주 7회),9.0,알고 있음,18,249,160,409,249,224,473,117
281,F,1992,3,475,429,904,자기계발,참고서,일반적인 영어 텍스트 기반 교재,주1-2회,1.0,알고 있지 않음,4,466,416,882,471,423,894,10
282,M,2006,3,176,267,443,자기계발,오프라인강의,일반적인 영어 텍스트 기반 교재,주5-6회,6.0,알고 있음,12,145,259,404,151,262,413,30
283,F,1984,3,364,381,745,자기계발,참고서,일반적인 영어 텍스트 기반 교재,주3-4회,3.0,알고 있음,7,332,353,685,339,356,695,50
284,M,1985,3,211,244,455,승진,참고서,일반적인 영어 텍스트 기반 교재,주3-4회,3.0,알고 있음,8,189,236,425,196,239,435,20
285,F,1998,3,276,290,566,자기계발,참고서,일반적인 영어 텍스트 기반 교재,주3-4회,5.0,알고 있음,8,227,241,468,251,265,516,50
286,M,1994,3,279,260,539,자기계발,참고서,일반적인 영어 텍스트 기반 교재,주1-2회,2.0,알고 있음,3,240,191,431,274,225,499,40
287,F,1998,3,478,482,960,취업,온라인강의,뉴스/이슈 기반 교재,주3-4회,5.0,알고 있음,7,354,358,712,395,399,794,166
288,M,1989,3,276,277,553,승진,오프라인강의,비즈니스 시뮬레이션(Role Play),주3-4회,3.0,알고 있음,9,147,235,382,247,248,495,58
289,F,1989,3,333,387,720,자기계발,온라인강의,일반적인 영어 텍스트 기반 교재,매일(주 7회),10.0,알고 있음,12,269,383,652,274,386,660,60
290,M,2007,3,432,428,860,자기계발,오프라인강의,영상 교재,주5-6회,7.0,알고 있음,11,428,339,767,431,346,777,83
291,F,1998,3,495,495,990,자기계발,온라인강의,영상 교재,주5-6회,5.0,알고 있음,13,479,379,858,480,432,912,78
292,M,1987,3,377,493,870,자기계발,오프라인강의,비즈니스 시뮬레이션(Role Play),주1-2회,2.0,알고 있음,5,324,491,815,330,492,822,48
293,F,1989,3,264,279,543,자기계발,참고서,일반적인 영어 텍스트 기반 교재,주5-6회,5.0,알고 있음,9,187,248,435,234,249,483,60
294,M,1983,3,286,282,568,자기계발,오프라인강의,뉴스/이슈 기반 교재,주3-4회,5.0,알고 있지 않음,10,278,269,547,281,275,556,12
295,F,1984,3,399,397,796,승진,오프라인강의,비즈니스 시뮬레이션(Role Play),매일(주 7회),9.0,알고 있음,14,335,333,668,365,363,728,68
296,M,1999,3,419,445,864,승진,온라인강의,비즈니스 시뮬레이션(Role Play),주1-2회,1.0,알고 있음,4,312,338,650,395,421,816,48
297,F,1984,3,217,351,568,자기계발,오프라인강의,영상 교재,주1-2회,2.0,알고 있지 않음,5,202,340,542,208,345,553,15
298,M,1983,3,495,495,990,승진,오프라인강의,영상 교재,주5-6회,8.0,알고 있음,13,439,441,880,469,471,940,50
299,F,1978,3,232,226,458,자기계발,온라인강의,뉴스/이슈 기반 교재,주3-4회,4.0,알고 있음,8,163,159,322,200,195,395,63
300,M,1991,3,393,379,772,자기계발,온라인강의,뉴스/이슈 기반 교재,주5-6회,7.0,알고 있음,12,353,337,690,356,342,698,74
301,F,1982,3,324,362,686,자기계발,온라인강의,뉴스/이슈 기반 교재,주1-2회,2.0,알고 있음,3,222,280,502,267,285,552,134
302,M,1989,3,231,225,456,자기계발,참고서,일반적인 영어 텍스트 기반 교재,매일(주 7회),8.0,알고 있지 않음,14,213,198,411,217,203,420,36
303,F,1991,3,343,364,707,자기계발,오프라인강의,영상 교재,주1-2회,2.0,알고 있음,4,273,264,537,291,289,580,127
304,M,1995,3,295,285,580,승진,온라인강의,뉴스/이슈 기반 교재,주3-4회,3.0,알고 있음,10,218,156,374,274,273,547,33
305,F,1974,3,401,403,804,승진,참고서,영상 교재,매일(주 7회),10.0,알고 있음,18,330,332,662,360,362,722,82
306,M,1989,3,295,295,590,자기계발,온라인강의,비즈니스 시뮬레이션(Role Play),주5-6회,5.0,알고 있음,11,295,223,518,295,232,527,63
307,F,2005,3,266,280,546,자기계발,오프라인강의,뉴스/이슈 기반 교재,주1-2회,1.0,알고 있음,4,262,218,480,265,227,492,54
308,M,1991,3,286,262,548,자기계발,오프라인강의,비즈니스 시뮬레이션(Role Play),주5-6회,6.0,알고 있음,10,181,164,345,213,198,411,137
309,F,1987,3,252,241,493,승진,오프라인강의,영상 교재,주5-6회,8.0,알고 있음,12,178,169,347,198,199,397,96
310,M,1990,3,239,217,456,자기계발,참고서,일반적인 영어 텍스트 기반 교재,매일(주 7회),9.0,알고 있음,20,205,179,384,209,187,396,60
311,F,1994,3,269,156,425,승진,온라인강의,비즈니스 시뮬레이션(Role Play),매일(주 7회),8.0,알고 있지 않음,16,262,142,404,265,148,413,12
312,M,2001,3,354,372,726,자기계발,온라인강의,뉴스/이슈 기반 교재,주5-6회,6.0,알고 있음,12,273,368,641,280,371,651,75
313,F,1995,3,198,258,456,승진,오프라인강의,비즈니스 시뮬레이션(Role Play),매일(주 7회),9.0,알고 있음,17,125,254,379,130,257,387,69
314,M,1982,3,141,294,435,자기계발,온라인강의,영상 교재,주1-2회,2.0,알고 있지 않음,3,129,292,421,136,293,429,6
315,F,1985,3,272,250,522,자기계발,온라인강의,영상 교재,주1-2회,2.0,알고 있음,3,249,170,419,269,190,459,63
316,M,1997,3,295,295,590,자기계발,온라인강의,일반적인 영어 텍스트 기반 교재,주3-4회,3.0,알고 있음,8,224,265,489,279,293,572,18
317,F,2007,3,346,386,732,자기계발,참고서,뉴스/이슈 기반 교재,주5-6회,7.0,알고 있음,16,267,308,575,309,349,658,74
318,M,2002,3,372,441,813,자기계발,오프라인강의,영상 교재,주5-6회,6.0,알고 있음,10,138,327,465,331,400,731,82
319,F,1988,3,287,229,516,자기계발,오프라인강의,비즈니스 시뮬레이션(Role Play),주5-6회,8.0,알고 있음,12,236,172,408,238,180,418,98
320,M,1979,3,495,495,990,자기계발,오프라인강의,비즈니스 시뮬레이션(Role Play),주3-4회,3.0,알고 있음,7,397,488,885,480,489,969,21
321,F,1998,3,493,445,938,자기계발,온라인강의,일반적인 영어 텍스트 기반 교재,주5-6회,6.0,알고 있음,11,491,407,898,492,415,907,31
322,M,1988,3,434,396,830,자기계발,참고서,일반적인 영어 텍스트 기반 교재,매일(주 7회),9.0,알고 있음,17,399,351,750,414,366,780,50
323,F,2001,3,439,403,842,자기계발,참고서,일반적인 영어 텍스트 기반 교재,주1-2회,2.0,알고 있음,3,431,393,824,434,398,832,10
324,M,1995,3,482,429,911,승진,온라인강의,비즈니스 시뮬레이션(Role Play),주3-4회,6.0,알고 있음,10,478,365,843,481,372,853,58
325,F,1994,3,391,492,883,승진,오프라인강의,비즈니스 시뮬레이션(Role Play),매일(주 7회),9.0,알고 있음,16,315,490,805,324,491,815,68
326,M,1982,3,261,264,525,자기계발,온라인강의,뉴스/이슈 기반 교재,주3-4회,3.0,알고 있지 않음,8,252,255,507,257,259,516,9
327,F,2005,3,443,433,876,자기계발,오프라인강의,영상 교재,매일(주 7회),7.0,알고 있음,14,355,427,782,360,432,792,84
328,M,1994,3,460,475,935,승진,오프라인강의,비즈니스 시뮬레이션(Role Play),매일(주 7회),9.0,알고 있음,17,458,380,838,458,472,930,5
329,F,1983,3,495,495,990,자기계발,오프라인강의,영상 교재,주1-2회,1.0,알고 있음,4,443,411,854,468,436,904,86
330,M,2002,3,314,335,649,자기계발,참고서,일반적인 영어 텍스트 기반 교재,주3-4회,5.0,알고 있음,8,297,305,602,300,305,605,44
331,F,1974,3,319,288,607,승진,오프라인강의,비즈니스 시뮬레이션(Role Play),주1-2회,2.0,알고 있음,3,296,235,531,300,241,541,66
332,M,2005,3,465,411,876,자기계발,온라인강의,뉴스/이슈 기반 교재,주1-2회,2.0,알고 있음,5,461,351,812,464,357,821,55
333,F,1997,3,295,292,587,자기계발,오프라인강의,뉴스/이슈 기반 교재,매일(주 7회),7.0,알고 있음,20,248,219,467,256,234,490,97
334,M,1990,3,321,315,636,자기계발,온라인강의,뉴스/이슈 기반 교재,주5-6회,8.0,알고 있음,11,298,278,576,312,301,613,23
335,F,1981,3,351,342,693,자기계발,참고서,뉴스/이슈 기반 교재,주3-4회,5.0,알고 있음,9,287,290,577,295,295,590,103
336,M,1988,3,439,476,915,승진,온라인강의,영상 교재,주5-6회,5.0,알고 있음,9,326,363,689,356,393,749,166
337,F,1989,3,295,295,590,자기계발,온라인강의,비즈니스 시뮬레이션(Role Play),매일(주 7회),10.0,알고 있음,18,271,288,559,288,289,577,13
338,M,1988,3,395,395,790,자기계발,오프라인강의,영상 교재,주5-6회,7.0,알고 있음,11,220,279,499,227,282,509,281
339,F,1986,3,289,287,576,승진,온라인강의,영상 교재,주5-6회,5.0,알고 있음,12,242,241,483,247,246,493,83
340,M,1986,3,273,276,549,자기계발,오프라인강의,영상 교재,주1-2회,2.0,알고 있음,5,183,185,368,227,229,456,93
341,F,1995,3,344,331,675,승진,온라인강의,비즈니스 시뮬레이션(Role Play),주5-6회,6.0,알고 있음,12,341,250,591,342,263,605,70
342,M,2004,3,408,429,837,자기계발,온라인강의,영상 교재,매일(주 7회),10.0,알고 있음,17,405,341,746,406,346,752,85
343,F,1988,3,267,295,562,승진,오프라인강의,비즈니스 시뮬레이션(Role Play),주3-4회,2.0,알고 있음,9,105,295,400,209,295,504,58
344,M,2003,3,295,295,590,자기계발,온라인강의,영상 교재,주1-2회,1.0,알고 있음,5,233,261,494,283,285,568,22
345,F,1985,3,295,295,590,자기계발,오프라인강의,영상 교재,매일(주 7회),9.0,알고 있음,16,250,254,504,274,278,552,38
346,M,2004,3,324,383,707,자기계발,참고서,뉴스/이슈 기반 교재,주1-2회,1.0,알고 있지 않음,5,313,370,683,318,376,694,13
347,F,1993,3,269,288,557,승진,오프라인강의,영상 교재,주5-6회,6.0,알고 있음,13,185,205,390,227,247,474,83
348,M,2000,3,434,444,878,자기계발,온라인강의,영상 교재,매일(주 7회),8.0,알고 있음,20,343,354,697,377,388,765,113
349,F,2003,3,284,225,509,자기계발,참고서,일반적인 영어 텍스트 기반 교재,주1-2회,2.0,알고 있음,5,278,214,492,279,220,499,10
350,M,1990,3,358,395,753,승진,오프라인강의,비즈니스 시뮬레이션(Role Play),주3-4회,6.0,알고 있음,10,301,384,685,330,392,722,31
351,F,2006,3,371,344,715,자기계발,온라인강의,뉴스/이슈 기반 교재,주5-6회,5.0,알고 있음,14,333,278,611,334,307,641,74
352,M,1982,3,295,295,590,자기계발,참고서,일반적인 영어 텍스트 기반 교재,주5-6회,5.0,알고 있음,12,249,241,490,290,282,572,18
353,F,2000,3,250,291,541,승진,오프라인강의,비즈니스 시뮬레이션(Role Play),주5-6회,7.0,알고 있음,15,150,231,381,216,257,473,68
354,M,2002,3,292,242,534,자기계발,온라인강의,영상 교재,매일(주 7회),9.0,알고 있음,16,290,151,441,291,159,450,84
355,F,2000,3,289,252,541,자기계발,오프라인강의,일반적인 영어 텍스트 기반 교재,주3-4회,5.0,알고 있음,8,252,214,466,279,241,520,21
356,M,1988,3,278,269,547,자기계발,온라인강의,영상 교재,주1-2회,2.0,알고 있음,3,231,176,407,232,223,455,92
357,F,1988,3,165,219,384,자기계발,참고서,일반적인 영어 텍스트 기반 교재,주1-2회,2.0,알고 있지 않음,5,152,213,365,158,216,374,10
358,M,1984,3,437,473,910,자기계발,온라인강의,뉴스/이슈 기반 교재,주1-2회,2.0,알고 있음,5,394,349,743,395,431,826,84
359,F,1979,3,360,336,696,자기계발,오프라인강의,비즈니스 시뮬레이션(Role Play),주1-2회,1.0,알고 있음,6,291,267,558,321,297,618,78
360,M,1989,3,439,405,844,자기계발,온라인강의,뉴스/이슈 기반 교재,주3-4회,4.0,알고 있음,5,336,401,737,345,403,748,96
361,F,1978,3,299,282,581,자기계발,참고서,일반적인 영어 텍스트 기반 교재,주1-2회,2.0,알고 있음,7,289,271,560,294,276,570,11
362,M,2003,3,373,346,719,자기계발,온라인강의,영상 교재,매일(주 7회),10.0,알고 있음,18,370,255,625,371,263,634,85
363,F,1988,3,454,429,883,승진,온라인강의,비즈니스 시뮬레이션(Role Play),주5-6회,8.0,알고 있음,14,368,343,711,420,395,815,68
364,M,1985,3,260,261,521,승진,오프라인강의,비즈니스 시뮬레이션(Role Play),주1-2회,2.0,알고 있음,4,232,192,424,236,237,473,48
365,F,1981,3,395,395,790,자기계발,오프라인강의,영상 교재,주5-6회,7.0,알고 있음,12,382,393,775,387,394,781,9
366,M,1993,3,393,382,775,취업,오프라인강의,영상 교재,주1-2회,1.0,알고 있음,6,279,322,601,286,323,609,166
367,F,2006,3,291,395,686,자기계발,참고서,일반적인 영어 텍스트 기반 교재,주3-4회,3.0,알고 있음,7,262,395,657,270,395,665,21
368,M,2000,3,395,366,761,자기계발,오프라인강의,뉴스/이슈 기반 교재,주1-2회,2.0,알고 있음,4,394,306,700,395,312,707,54
369,F,2001,3,267,385,652,자기계발,온라인강의,일반적인 영어 텍스트 기반 교재,매일(주 7회),10.0,알고 있음,19,232,381,613,240,382,622,30
370,M,2001,3,401,406,807,자기계발,온라인강의,뉴스/이슈 기반 교재,주5-6회,7.0,알고 있음,16,357,366,723,364,369,733,74
371,F,1995,3,295,273,568,승진,온라인강의,비즈니스 시뮬레이션(Role Play),주3-4회,3.0,알고 있음,9,219,217,436,256,237,493,75
372,M,1996,3,295,295,590,자기계발,온라인강의,영상 교재,매일(주 7회),10.0,알고 있음,19,258,224,482,287,253,540,50
373,F,2003,3,275,268,543,자기계발,온라인강의,영상 교재,주3-4회,3.0,알고 있음,4,224,217,441,239,232,471,72
374,M,1992,3,284,280,564,승진,오프라인강의,영상 교재,주1-2회,2.0,알고 있음,6,233,171,404,253,249,502,62
375,F,1993,3,295,295,590,승진,참고서,뉴스/이슈 기반 교재,주3-4회,3.0,알고 있음,8,254,246,500,295,295,590,0
376,M,2004,3,244,258,502,자기계발,참고서,일반적인 영어 텍스트 기반 교재,주5-6회,7.0,알고 있음,16,198,212,410,229,243,472,30
377,F,1988,3,335,318,653,승진,오프라인강의,비즈니스 시뮬레이션(Role Play),매일(주 7회),10.0,알고 있음,16,278,235,513,280,241,521,132
378,M,1999,3,381,422,803,승진,오프라인강의,비즈니스 시뮬레이션(Role Play),주3-4회,4.0,알고 있음,9,315,419,734,324,420,744,59
379,F,2002,3,371,395,766,자기계발,온라인강의,영상 교재,매일(주 7회),7.0,알고 있음,20,315,339,654,330,354,684,82
380,M,1981,3,215,287,502,승진,참고서,일반적인 영어 텍스트 기반 교재,주5-6회,5.0,알고 있음,14,182,281,463,190,282,472,30
381,F,1983,3,295,295,590,승진,온라인강의,비즈니스 시뮬레이션(Role Play),주5-6회,6.0,알고 있음,17,282,258,540,295,295,590,0
382,M,2007,3,372,356,728,자기계발,참고서,일반적인 영어 텍스트 기반 교재,매일(주 7회),10.0,알고 있음,16,284,331,615,357,341,698,30
383,F,1984,3,248,303,551,자기계발,참고서,뉴스/이슈 기반 교재,주5-6회,5.0,알고 있지 않음,10,235,295,530,241,300,541,10
384,M,1999,3,368,379,747,자기계발,온라인강의,영상 교재,주1-2회,2.0,알고 있음,3,344,252,596,345,309,654,93
385,F,1991,3,335,347,682,자기계발,오프라인강의,뉴스/이슈 기반 교재,매일(주 7회),10.0,알고 있음,13,278,292,570,283,295,578,104
386,M,1992,3,395,395,790,자기계발,온라인강의,비즈니스 시뮬레이션(Role Play),주5-6회,7.0,알고 있음,14,371,225,596,372,328,700,90
387,F,1981,3,413,433,846,자기계발,온라인강의,뉴스/이슈 기반 교재,주3-4회,3.0,알고 있음,9,329,349,678,366,386,752,94
388,M,1986,3,257,262,519,승진,오프라인강의,비즈니스 시뮬레이션(Role Play),주3-4회,4.0,알고 있음,9,253,168,421,256,175,431,88
389,F,1997,3,495,495,990,승진,오프라인강의,비즈니스 시뮬레이션(Role Play),주5-6회,8.0,알고 있음,5,363,375,738,456,468,924,66
390,M,2002,3,268,311,579,자기계발,참고서,일반적인 영어 텍스트 기반 교재,매일(주 7회),10.0,알고 있음,18,202,308,510,209,310,519,60
391,F,1994,3,437,433,870,자기계발,온라인강의,일반적인 영어 텍스트 기반 교재,주3-4회,3.0,알고 있음,4,411,351,762,412,408,820,50
392,M,2005,3,298,295,593,자기계발,참고서,뉴스/이슈 기반 교재,주5-6회,6.0,알고 있음,7,244,286,530,278,295,573,20
393,F,1979,3,405,435,840,승진,오프라인강의,비즈니스 시뮬레이션(Role Play),주5-6회,7.0,알고 있음,9,312,400,712,371,401,772,68
394,M,1992,3,295,295,590,자기계발,온라인강의,뉴스/이슈 기반 교재,주3-4회,6.0,알고 있음,8,287,232,519,289,239,528,62
395,F,1986,3,295,295,590,자기계발,오프라인강의,영상 교재,주1-2회,2.0,알고 있음,3,232,287,519,239,289,528,62
396,M,1992,3,382,345,727,자기계발,참고서,일반적인 영어 텍스트 기반 교재,주1-2회,1.0,알고 있음,6,380,297,677,381,306,687,40
397,F,1995,3,278,323,601,승진,참고서,뉴스/이슈 기반 교재,주3-4회,3.0,알고 있지 않음,4,266,317,583,271,319,590,11
398,M,2004,3,495,495,990,자기계발,온라인강의,영상 교재,매일(주 7회),10.0,알고 있음,14,462,462,924,466,467,933,57
399,F,2000,3,373,387,760,자기계발,참고서,뉴스/이슈 기반 교재,주3-4회,3.0,알고 있음,5,310,324,634,341,355,696,64
400,M,1989,3,363,372,735,자기계발,온라인강의,뉴스/이슈 기반 교재,주1-2회,2.0,알고 있음,6,261,310,571,311,320,631,104
401,F,1987,3,427,464,891,자기계발,온라인강의,뉴스/이슈 기반 교재,주3-4회,4.0,알고 있음,6,313,416,729,380,417,797,94
402,M,1984,3,448,424,872,자기계발,온라인강의,비즈니스 시뮬레이션(Role Play),주5-6회,6.0,알고 있음,8,369,345,714,399,375,774,98
403,F,1992,3,395,395,790,자기계발,온라인강의,영상 교재,주5-6회,5.0,알고 있음,8,336,343,679,340,346,686,104
404,M,1998,3,395,395,790,승진,온라인강의,영상 교재,주5-6회,5.0,알고 있음,11,367,255,622,395,394,789,1
405,F,1983,3,347,390,737,승진,오프라인강의,비즈니스 시뮬레이션(Role Play),매일(주 7회),9.0,알고 있음,11,221,388,609,280,389,669,68
406,M,1983,3,371,345,716,자기계발,온라인강의,뉴스/이슈 기반 교재,주3-4회,3.0,알고 있음,8,368,245,613,370,251,621,95
407,F,1995,3,319,312,631,승진,온라인강의,뉴스/이슈 기반 교재,매일(주 7회),8.0,알고 있음,14,315,234,549,318,239,557,74
408,M,1991,3,298,309,607,자기계발,참고서,일반적인 영어 텍스트 기반 교재,주1-2회,2.0,알고 있음,3,251,304,555,259,308,567,40
409,F,2001,3,231,221,452,자기계발,오프라인강의,영상 교재,매일(주 7회),7.0,알고 있음,16,172,143,315,190,187,377,75
410,M,1995,3,436,472,908,승진,온라인강의,영상 교재,주5-6회,6.0,알고 있음,10,337,375,712,394,431,825,83
411,F,1992,3,331,311,642,자기계발,오프라인강의,일반적인 영어 텍스트 기반 교재,매일(주 7회),8.0,알고 있음,13,274,235,509,301,299,600,42
412,M,2006,3,263,357,620,자기계발,온라인강의,일반적인 영어 텍스트 기반 교재,주1-2회,2.0,알고 있지 않음,3,252,351,603,258,354,612,8
413,F,1993,3,281,294,575,승진,온라인강의,영상 교재,매일(주 7회),9.0,알고 있음,19,119,151,270,241,231,472,103
414,M,1979,3,302,312,614,자기계발,온라인강의,뉴스/이슈 기반 교재,주1-2회,1.0,알고 있음,6,271,261,532,276,265,541,73
415,F,1995,3,464,470,934,자기계발,온라인강의,뉴스/이슈 기반 교재,주3-4회,4.0,알고 있음,7,368,374,742,417,423,840,94
416,M,1987,3,199,174,373,자기계발,오프라인강의,영상 교재,주5-6회,9.0,알고 있음,16,129,121,250,131,129,260,113
417,F,1993,3,458,454,912,자기계발,온라인강의,뉴스/이슈 기반 교재,주1-2회,2.0,알고 있음,3,414,405,819,416,412,828,84
418,M,1988,3,374,452,826,자기계발,온라인강의,뉴스/이슈 기반 교재,주5-6회,8.0,알고 있음,13,316,397,713,322,400,722,104
419,F,1992,3,487,479,966,승진,온라인강의,영상 교재,매일(주 7회),9.0,알고 있음,18,445,398,843,446,437,883,83
420,M,1990,3,495,495,990,자기계발,온라인강의,일반적인 영어 텍스트 기반 교재,주5-6회,6.0,알고 있음,12,487,458,945,488,466,954,36
421,F,1985,3,495,495,990,승진,오프라인강의,영상 교재,매일(주 7회),7.0,알고 있음,20,477,425,902,478,464,942,48
422,M,2001,3,495,495,990,자기계발,참고서,일반적인 영어 텍스트 기반 교재,주3-4회,4.0,알고 있음,5,440,467,907,490,491,981,9
423,F,1985,3,495,495,990,자기계발,오프라인강의,영상 교재,주5-6회,8.0,알고 있음,11,381,485,866,389,487,876,114
424,M,1981,3,495,495,990,승진,오프라인강의,비즈니스 시뮬레이션(Role Play),주1-2회,3.0,알고 있음,4,480,404,884,493,489,982,8
425,F,1987,3,260,258,518,승진,오프라인강의,비즈니스 시뮬레이션(Role Play),주1-2회,1.0,알고 있음,6,256,204,460,259,211,470,48
426,M,1991,3,478,480,958,승진,참고서,뉴스/이슈 기반 교재,주3-4회,4.0,알고 있음,7,334,447,781,446,448,894,64
427,F,1998,3,321,256,577,승진,오프라인강의,비즈니스 시뮬레이션(Role Play),매일(주 7회),10.0,알고 있음,17,284,248,532,287,252,539,38
428,M,1996,3,413,394,807,승진,오프라인강의,영상 교재,주1-2회,1.0,알고 있음,5,408,326,734,412,332,744,63
429,F,1993,3,495,495,990,자기계발,온라인강의,뉴스/이슈 기반 교재,매일(주 7회),7.0,알고 있음,20,370,466,836,472,467,939,51
430,M,1980,3,493,494,987,자기계발,오프라인강의,영상 교재,주5-6회,6.0,알고 있음,15,396,428,824,421,453,874,113
431,F,2005,3,423,460,883,자기계발,참고서,뉴스/이슈 기반 교재,매일(주 7회),10.0,알고 있음,16,342,458,800,350,459,809,74
432,M,1996,3,495,495,990,승진,온라인강의,영상 교재,주1-2회,1.0,알고 있음,5,406,382,788,489,465,954,36
433,F,2000,3,247,272,519,자기계발,참고서,일반적인 영어 텍스트 기반 교재,주1-2회,2.0,알고 있음,5,205,230,435,242,267,509,10
434,M,1997,3,495,495,990,승진,온라인강의,비즈니스 시뮬레이션(Role Play),주5-6회,5.0,알고 있음,17,456,471,927,493,494,987,3
435,F,1995,3,495,495,990,승진,참고서,일반적인 영어 텍스트 기반 교재,주1-2회,1.0,알고 있음,5,474,390,864,495,495,990,0
436,M,2001,3,361,339,700,자기계발,온라인강의,영상 교재,주5-6회,7.0,알고 있지 않음,12,352,330,682,357,334,691,9
437,F,2003,3,444,490,934,자기계발,오프라인강의,뉴스/이슈 기반 교재,매일(주 7회),10.0,알고 있음,5,363,487,850,371,489,860,74
438,M,1982,3,495,471,966,자기계발,참고서,뉴스/이슈 기반 교재,매일(주 7회),10.0,알고 있음,14,495,358,853,495,367,862,104
439,F,1985,3,443,441,884,자기계발,오프라인강의,비즈니스 시뮬레이션(Role Play),주5-6회,5.0,알고 있음,9,327,439,766,346,440,786,98
440,M,2007,3,431,399,830,자기계발,온라인강의,영상 교재,주1-2회,2.0,알고 있음,4,428,329,757,430,337,767,63
441,F,2000,3,493,480,973,자기계발,온라인강의,뉴스/이슈 기반 교재,주3-4회,4.0,알고 있음,8,420,407,827,461,448,909,64
442,M,1990,3,467,446,913,자기계발,오프라인강의,비즈니스 시뮬레이션(Role Play),주3-4회,3.0,알고 있음,7,372,444,816,380,445,825,88
443,F,1991,3,495,495,990,승진,온라인강의,비즈니스 시뮬레이션(Role Play),매일(주 7회),9.0,알고 있음,15,430,475,905,494,495,989,1
444,M,1997,3,271,261,532,승진,참고서,일반적인 영어 텍스트 기반 교재,주5-6회,8.0,알고 있음,9,246,224,470,251,231,482,50
445,F,1997,3,395,395,790,자기계발,온라인강의,영상 교재,주5-6회,6.0,알고 있음,12,389,324,713,390,333,723,67
446,M,1995,3,224,347,571,자기계발,온라인강의,뉴스/이슈 기반 교재,매일(주 7회),10.0,알고 있지 않음,14,214,340,554,219,344,563,8
447,F,1979,3,197,198,395,자기계발,온라인강의,일반적인 영어 텍스트 기반 교재,주1-2회,2.0,알고 있음,5,159,142,301,162,154,316,79
448,M,1985,3,321,328,649,승진,오프라인강의,영상 교재,주5-6회,7.0,알고 있음,12,280,271,551,301,300,601,48
449,F,1987,3,432,421,853,승진,참고서,일반적인 영어 텍스트 기반 교재,주1-2회,2.0,알고 있음,5,397,384,781,428,415,843,10
450,M,2006,3,377,328,705,자기계발,참고서,일반적인 영어 텍스트 기반 교재,주1-2회,4.0,알고 있음,1,373,311,684,376,319,695,10
451,F,1977,3,303,297,600,자기계발,온라인강의,일반적인 영어 텍스트 기반 교재,매일(주 7회),10.0,알고 있음,13,275,280,555,279,282,561,39
452,M,1980,3,339,341,680,자기계발,참고서,일반적인 영어 텍스트 기반 교재,주1-2회,2.0,알고 있음,3,301,265,566,338,302,640,40
453,F,1999,3,446,462,908,자기계발,온라인강의,영상 교재,주5-6회,6.0,알고 있음,12,365,381,746,390,406,796,112
454,M,1991,3,295,295,590,자기계발,온라인강의,영상 교재,주3-4회,3.0,알고 있음,6,245,251,496,249,256,505,85
455,F,2005,3,393,378,771,자기계발,참고서,일반적인 영어 텍스트 기반 교재,매일(주 7회),10.0,알고 있음,14,377,281,658,378,363,741,30
456,M,1996,3,330,328,658,승진,온라인강의,비즈니스 시뮬레이션(Role Play),주3-4회,3.0,알고 있음,5,281,280,561,320,293,613,45
457,F,2000,3,439,462,901,자기계발,온라인강의,영상 교재,매일(주 7회),10.0,알고 있음,18,381,344,725,382,406,788,113
458,M,1990,3,423,400,823,승진,온라인강의,영상 교재,주3-4회,4.0,알고 있음,8,419,323,742,422,328,750,73
459,F,1975,3,243,359,602,자기계발,오프라인강의,일반적인 영어 텍스트 기반 교재,주3-4회,5.0,알고 있음,10,218,351,569,241,359,600,2
460,M,1989,3,301,273,574,자기계발,온라인강의,영상 교재,매일(주 7회),9.0,알고 있음,16,213,197,410,236,211,447,127
461,F,1999,3,384,383,767,자기계발,참고서,일반적인 영어 텍스트 기반 교재,매일(주 7회),10.0,알고 있음,16,293,380,673,355,381,736,31
462,M,1979,3,326,364,690,자기계발,참고서,일반적인 영어 텍스트 기반 교재,주3-4회,5.0,알고 있음,12,278,338,616,301,339,640,50
463,F,2007,3,400,437,837,자기계발,온라인강의,뉴스/이슈 기반 교재,주1-2회,2.0,알고 있음,3,340,435,775,347,436,783,54
464,M,1990,3,425,391,816,자기계발,온라인강의,뉴스/이슈 기반 교재,매일(주 7회),9.0,알고 있음,18,370,334,704,373,339,712,104
465,F,2003,3,395,415,810,자기계발,참고서,일반적인 영어 텍스트 기반 교재,주1-2회,1.0,알고 있음,3,382,409,791,390,410,800,10
466,M,1999,3,383,382,765,자기계발,참고서,뉴스/이슈 기반 교재,매일(주 7회),10.0,알고 있음,14,371,279,650,372,288,660,105
467,F,2002,3,274,283,557,자기계발,참고서,뉴스/이슈 기반 교재,매일(주 7회),8.0,알고 있음,20,236,164,400,237,246,483,74
468,M,2000,3,355,379,734,자기계발,온라인강의,영상 교재,주1-2회,2.0,알고 있음,3,316,345,661,323,348,671,63
469,F,1985,3,383,375,758,승진,참고서,일반적인 영어 텍스트 기반 교재,주3-4회,3.0,알고 있음,7,322,312,634,374,364,738,20
470,M,2006,3,261,242,503,자기계발,오프라인강의,영상 교재,주5-6회,6.0,알고 있음,10,218,192,410,220,200,420,83
471,F,1999,3,242,265,507,승진,참고서,일반적인 영어 텍스트 기반 교재,주5-6회,6.0,알고 있음,8,220,247,467,227,250,477,30
472,M,2001,3,311,313,624,자기계발,온라인강의,뉴스/이슈 기반 교재,주1-2회,2.0,알고 있음,5,218,228,446,255,264,519,105
473,F,1990,3,309,339,648,자기계발,온라인강의,일반적인 영어 텍스트 기반 교재,주3-4회,3.0,알고 있음,9,294,325,619,301,335,636,12
474,M,1991,3,235,258,493,자기계발,오프라인강의,뉴스/이슈 기반 교재,매일(주 7회),8.0,알고 있음,12,232,136,368,233,155,388,105
475,F,1994,3,389,395,784,승진,참고서,일반적인 영어 텍스트 기반 교재,매일(주 7회),10.0,알고 있음,15,344,350,694,374,380,754,30
476,M,1984,3,296,349,645,자기계발,온라인강의,뉴스/이슈 기반 교재,주3-4회,3.0,알고 있지 않음,7,283,343,626,289,346,635,10
477,F,1986,3,395,373,768,자기계발,오프라인강의,비즈니스 시뮬레이션(Role Play),매일(주 7회),10.0,알고 있음,16,291,245,536,310,295,605,163
478,M,2000,3,396,394,790,승진,온라인강의,비즈니스 시뮬레이션(Role Play),주3-4회,3.0,알고 있음,7,337,335,672,367,365,732,58
479,F,1996,3,256,210,466,승진,온라인강의,비즈니스 시뮬레이션(Role Play),매일(주 7회),9.0,알고 있음,16,242,168,410,243,182,425,41
480,M,2004,3,308,294,602,자기계발,온라인강의,뉴스/이슈 기반 교재,주5-6회,5.0,알고 있음,17,219,286,505,251,301,552,50
481,F,1988,3,315,328,643,자기계발,온라인강의,비즈니스 시뮬레이션(Role Play),주3-4회,3.0,알고 있음,8,287,319,606,301,327,628,15
482,M,1987,3,355,355,710,자기계발,온라인강의,영상 교재,주1-2회,1.0,알고 있음,5,275,329,604,294,337,631,79
483,F,2003,3,474,453,927,자기계발,오프라인강의,영상 교재,주3-4회,5.0,알고 있음,7,453,327,780,454,400,854,73
484,M,1998,3,380,370,750,자기계발,참고서,일반적인 영어 텍스트 기반 교재,주5-6회,9.0,알고 있음,11,373,268,641,374,365,739,11
485,F,1992,3,484,482,966,자기계발,오프라인강의,영상 교재,주3-4회,4.0,알고 있음,6,328,451,779,411,452,863,103
486,M,1981,3,310,321,631,승진,참고서,일반적인 영어 텍스트 기반 교재,주3-4회,3.0,알고 있음,6,228,210,438,230,219,449,182
487,F,1974,3,431,432,863,자기계발,온라인강의,영상 교재,매일(주 7회),9.0,알고 있음,18,371,371,742,375,376,751,112
488,M,1989,3,252,227,479,승진,참고서,일반적인 영어 텍스트 기반 교재,주5-6회,5.0,알고 있음,10,234,206,440,237,212,449,30
489,F,1978,3,431,413,844,자기계발,오프라인강의,일반적인 영어 텍스트 기반 교재,주1-2회,2.0,알고 있음,3,396,340,736,430,374,804,40
490,M,1992,3,362,341,703,자기계발,참고서,일반적인 영어 텍스트 기반 교재,주5-6회,6.0,알고 있음,9,286,263,549,333,310,643,60
491,F,1985,3,287,330,617,승진,참고서,일반적인 영어 텍스트 기반 교재,매일(주 7회),9.0,알고 있음,17,269,331,600,271,338,609,8
492,M,1980,3,301,321,622,자기계발,오프라인강의,비즈니스 시뮬레이션(Role Play),매일(주 7회),10.0,알고 있음,16,204,201,405,241,238,479,143
493,F,2002,3,420,427,847,자기계발,참고서,뉴스/이슈 기반 교재,매일(주 7회),8.0,알고 있음,19,378,388,766,383,390,773,74
494,M,1996,3,301,310,611,승진,참고서,뉴스/이슈 기반 교재,주3-4회,3.0,알고 있음,6,276,251,527,299,301,600,11
495,F,2007,3,267,275,542,자기계발,온라인강의,영상 교재,주1-2회,0.0,알고 있음,5,221,229,450,236,244,480,62
496,M,2006,3,364,336,700,자기계발,온라인강의,일반적인 영어 텍스트 기반 교재,매일(주 7회),10.0,알고 있음,13,347,315,662,349,321,670,30
497,F,1988,3,187,252,439,승진,온라인강의,비즈니스 시뮬레이션(Role Play),매일(주 7회),9.0,알고 있음,17,112,250,362,120,251,371,68
498,M,2006,3,255,167,422,자기계발,오프라인강의,일반적인 영어 텍스트 기반 교재,주1-2회,0.0,알고 있음,4,252,150,402,254,158,412,10
499,F,1990,3,422,370,792,자기계발,오프라인강의,비즈니스 시뮬레이션(Role Play),주3-4회,4.0,알고 있음,7,371,324,695,378,326,704,88
500,M,1984,3,235,226,461,승진,오프라인강의,비즈니스 시뮬레이션(Role Play),주5-6회,7.0,알고 있음,15,169,188,357,172,190,362,99
